iteration,game_number,winner,total_moves,player_1_moves,player_minus1_moves,player_1_time_seconds,player_minus1_time_seconds,final_pieces_p1,final_pieces_p_1
0,1,-1,73,37,36,4.356,4.205,6,7
0,2,0,287,144,143,15.114,14.728,3,3
0,3,-1,170,85,85,8.962,8.72,0,6
0,4,-1,156,78,78,8.707,7.958,3,6
0,5,-1,136,68,68,7.073,6.822,0,7
0,6,1,211,106,105,11.486,11.451,5,0
0,7,1,159,80,79,8.052,8.09,4,3
0,8,1,215,108,107,10.876,10.758,4,2
0,9,-1,192,96,96,10.578,10.313,2,3
0,10,1,123,62,61,6.375,6.286,4,2
0,11,-1,205,103,102,10.478,10.155,2,6
0,12,-1,128,64,64,6.985,6.555,0,6
0,13,0,183,92,91,9.417,9.274,3,3
0,14,-1,104,52,52,5.628,5.465,0,6
0,15,-1,212,106,106,11.532,11.251,0,5
0,16,-1,142,71,71,7.576,6.979,0,5
0,17,-1,166,83,83,8.324,8.319,2,5
0,18,1,141,71,70,7.373,7.098,4,3
0,19,-1,142,71,71,7.264,7.254,0,7
0,20,-1,126,63,63,6.53,6.72,0,5
1,1,1,173,87,86,9.906,9.393,6,0
1,2,-1,172,86,86,8.849,8.683,2,3
1,3,-1,162,81,81,8.746,8.524,0,5
1,4,1,205,103,102,10.993,10.896,4,2
1,5,1,141,71,70,7.861,7.423,8,4
1,6,1,141,71,70,7.832,7.181,6,1
1,7,1,145,73,72,7.706,7.617,6,0
1,8,1,124,62,62,6.75,6.484,4,3
1,9,-1,230,115,115,12.435,12.121,1,2
1,10,1,69,35,34,3.307,3.22,8,6
1,11,0,50,25,25,2.924,2.955,8,8
1,12,-1,254,127,127,12.921,12.903,1,2
1,13,1,91,46,45,5.182,5.042,8,6
1,14,1,93,47,46,5.252,5.209,8,5
1,15,1,227,114,113,12.045,11.645,3,2
1,16,1,115,58,57,6.207,5.779,4,2
1,17,1,147,74,73,7.823,7.669,6,3
1,18,-1,210,105,105,11.459,11.362,1,4
1,19,1,145,73,72,7.773,7.472,6,1
1,20,-1,114,57,57,6.118,6.086,5,7
2,1,1,179,90,89,9.765,9.615,7,3
2,2,1,57,29,28,3.124,2.957,8,7
2,3,-1,204,102,102,10.455,10.034,1,2
2,4,1,87,44,43,4.864,4.749,8,6
2,5,0,50,25,25,2.464,2.562,8,8
2,6,1,251,126,125,13.617,12.974,7,4
2,7,1,111,56,55,6.077,6.048,8,6
2,8,1,77,39,38,4.367,4.317,8,7
2,9,0,50,25,25,2.287,2.22,8,8
2,10,-1,62,31,31,3.05,2.978,7,8
2,11,0,50,25,25,3.157,2.82,8,8
2,12,1,141,71,70,7.484,7.191,8,4
2,13,-1,162,81,81,8.363,8.488,0,5
2,14,0,90,45,45,5.076,4.848,7,7
2,15,0,50,25,25,2.613,2.274,8,8
2,16,1,95,48,47,5.348,5.19,8,7
2,17,1,77,39,38,3.849,3.595,8,4
2,18,0,107,54,53,5.901,5.895,6,6
2,19,-1,146,73,73,7.475,7.853,1,7
2,20,1,171,86,85,9.404,8.812,7,5
3,1,1,101,51,50,5.677,5.44,8,6
3,2,1,87,44,43,4.271,3.932,8,6
3,3,0,50,25,25,3.076,2.975,8,8
3,4,0,50,25,25,2.281,2.191,8,8
3,5,0,50,25,25,2.46,2.315,8,8
3,6,1,59,30,29,3.374,3.522,8,7
3,7,-1,210,105,105,10.331,10.254,1,3
3,8,1,231,116,115,12.121,12.301,5,2
3,9,0,50,25,25,2.402,2.492,8,8
3,10,0,117,59,58,6.28,6.06,7,7
3,11,1,91,46,45,5.296,4.873,7,5
3,12,1,85,43,42,4.51,4.402,8,6
3,13,0,50,25,25,2.493,2.347,8,8
3,14,1,197,99,98,10.19,9.498,7,2
3,15,0,50,25,25,3.299,2.978,8,8
3,16,1,191,96,95,9.621,9.512,7,2
3,17,1,105,53,52,5.605,5.463,8,3
3,18,0,50,25,25,2.465,2.21,8,8
3,19,0,50,25,25,2.764,2.634,8,8
3,20,-1,220,110,110,10.857,10.958,2,5
4,1,0,50,25,25,2.295,2.168,8,8
4,2,0,50,25,25,2.474,2.377,8,8
4,3,0,50,25,25,2.873,2.781,8,8
4,4,1,193,97,96,10.08,9.595,5,3
4,5,1,187,94,93,10.096,9.904,7,4
4,6,-1,270,135,135,13.795,13.646,0,5
4,7,-1,58,29,29,3.234,2.932,7,8
4,8,-1,228,114,114,11.997,11.931,2,3
4,9,1,197,99,98,9.782,9.535,3,1
4,10,1,205,103,102,11.145,10.523,6,3
4,11,1,80,40,40,4.372,3.957,7,6
4,12,-1,58,29,29,2.965,2.855,7,8
4,13,1,213,107,106,11.255,10.989,7,1
4,14,0,50,25,25,2.584,2.325,8,8
4,15,-1,73,37,36,4.166,3.936,6,7
4,16,1,160,80,80,8.328,7.838,4,2
4,17,0,50,25,25,2.505,2.39,8,8
4,18,0,50,25,25,2.821,2.666,8,8
4,19,0,50,25,25,2.278,2.159,8,8
4,20,0,50,25,25,2.607,2.788,8,8
5,1,1,123,62,61,6.47,6.199,6,5
5,2,0,50,25,25,2.635,2.621,8,8
5,3,0,50,25,25,2.923,2.554,8,8
5,4,1,176,88,88,9.246,8.815,5,4
5,5,-1,102,51,51,5.561,5.428,2,8
5,6,-1,124,62,62,7.055,6.703,6,7
5,7,1,61,31,30,2.936,2.791,8,6
5,8,1,99,50,49,5.604,5.591,8,7
5,9,0,50,25,25,2.35,2.324,8,8
5,10,0,50,25,25,3.164,3.032,8,8
5,11,0,50,25,25,2.553,2.242,8,8
5,12,-1,288,144,144,15.127,14.861,1,2
5,13,-1,218,109,109,11.853,11.736,2,4
5,14,-1,71,36,35,3.386,3.308,6,7
5,15,0,50,25,25,3.132,2.995,8,8
5,16,0,50,25,25,2.284,2.424,8,8
5,17,-1,96,48,48,5.414,5.195,7,8
5,18,0,120,60,60,6.462,6.451,4,4
5,19,-1,85,43,42,4.104,3.879,6,7
5,20,0,50,25,25,3.196,2.991,8,8
6,1,0,50,25,25,2.562,2.57,8,8
6,2,1,140,70,70,11.965,11.158,7,5
6,3,0,50,25,25,3.009,2.822,8,8
6,4,1,71,36,35,4.807,4.853,8,7
6,5,0,50,25,25,2.452,2.36,8,8
6,6,0,50,25,25,2.581,2.547,8,8
6,7,-1,194,97,97,10.399,10.543,1,3
6,8,0,219,110,109,11.231,11.288,2,2
6,9,1,187,94,93,10.19,9.872,4,2
6,10,1,65,33,32,3.053,2.991,8,7
6,11,1,117,59,58,6.486,6.42,7,6
6,12,1,86,43,43,4.811,4.621,7,6
6,13,1,101,51,50,5.417,5.406,8,5
6,14,1,97,49,48,4.742,4.536,8,7
6,15,-1,166,83,83,8.68,8.903,1,5
6,16,0,50,25,25,2.722,2.694,8,8
6,17,1,199,100,99,10.302,9.824,6,0
6,18,0,72,36,36,4.284,3.958,7,7
6,19,1,63,32,31,2.964,2.838,8,6
6,20,0,149,75,74,7.932,7.636,3,3
7,1,1,123,62,61,6.607,6.318,7,6
7,2,1,195,98,97,10.985,10.322,6,4
7,3,0,50,25,25,2.338,2.284,8,8
7,4,1,63,32,31,3.607,3.774,8,7
7,5,1,237,119,118,12.265,11.936,5,2
7,6,-1,220,110,110,11.659,11.905,0,2
7,7,0,87,44,43,4.736,4.517,7,7
7,8,0,50,25,25,2.594,2.494,8,8
7,9,0,70,35,35,3.771,3.455,7,7
7,10,-1,175,88,87,9.39,9.42,4,6
7,11,1,197,99,98,10.007,10.042,4,1
7,12,1,107,54,53,5.83,5.895,6,4
7,13,-1,60,30,30,3.028,2.854,7,8
7,14,0,87,44,43,4.741,4.499,7,7
7,15,-1,96,48,48,5.429,5.2,5,8
7,16,0,50,25,25,2.27,2.281,8,8
7,17,1,279,140,139,14.604,14.316,2,1
7,18,0,50,25,25,2.729,2.672,8,8
7,19,1,128,64,64,6.843,6.315,6,4
7,20,1,299,150,149,16.346,15.592,2,1
8,1,1,93,47,46,5.013,4.627,7,4
8,2,-1,143,72,71,7.853,7.576,6,7
8,3,1,73,37,36,3.945,3.568,7,6
8,4,1,115,58,57,6.253,6.125,7,5
8,5,1,67,34,33,3.377,3.52,8,7
8,6,0,50,25,25,2.886,2.803,8,8
8,7,1,185,93,92,9.44,9.567,3,0
8,8,0,50,25,25,2.882,2.826,8,8
8,9,-1,82,41,41,4.047,3.889,7,8
8,10,0,97,49,48,5.319,5.377,7,7
8,11,1,217,109,108,11.635,11.047,7,3
8,12,1,233,117,116,12.566,12.309,5,4
8,13,1,130,65,65,6.868,6.839,4,3
8,14,1,236,118,118,12.999,12.489,4,3
8,15,1,155,78,77,8.104,8.093,5,1
8,16,1,111,56,55,6.156,5.975,7,6
8,17,1,105,53,52,5.956,5.683,8,4
8,18,1,95,48,47,4.843,4.479,8,7
8,19,0,50,25,25,3.146,3.011,8,8
8,20,1,89,45,44,4.358,4.167,8,6
9,1,0,50,25,25,2.36,2.56,8,8
9,2,0,78,39,39,4.547,4.445,7,7
9,3,1,87,44,43,4.132,4.022,8,7
9,4,1,245,123,122,13.301,13.197,5,1
9,5,1,209,105,104,11.744,11.158,4,0
9,6,-1,130,65,65,6.917,7.12,0,4
9,7,1,101,51,50,5.158,4.999,7,5
9,8,0,50,25,25,3.214,2.891,8,8
9,9,0,50,25,25,2.34,2.292,8,8
9,10,1,97,49,48,5.466,5.39,8,7
9,11,0,83,42,41,4.348,4.605,7,7
9,12,1,174,87,87,9.125,9.059,4,3
9,13,1,75,38,37,3.576,3.566,8,7
9,14,0,50,25,25,3.203,3.079,8,8
9,15,1,65,33,32,3.145,3.269,8,7
9,16,0,63,32,31,3.77,3.591,7,7
9,17,1,103,52,51,5.406,5.08,8,5
9,18,0,50,25,25,2.793,2.74,8,8
9,19,1,185,93,92,9.925,9.42,8,3
9,20,1,57,29,28,3.432,3.351,8,7
10,1,0,50,25,25,2.527,2.662,8,8
10,2,1,251,126,125,12.97,12.878,7,4
10,3,0,50,25,25,3.077,2.94,8,8
10,4,0,50,25,25,2.278,2.172,8,8
10,5,0,50,25,25,2.308,2.486,8,8
10,6,1,97,49,48,5.317,5.035,8,7
10,7,0,79,40,39,4.679,4.203,7,7
10,8,0,128,64,64,6.417,6.206,7,7
10,9,-1,116,58,58,5.557,5.638,1,4
10,10,0,86,43,43,4.756,4.554,7,7
10,11,0,98,49,49,5.253,5.426,7,7
10,12,1,219,110,109,10.932,10.623,5,2
10,13,0,50,25,25,3.31,2.948,8,8
10,14,1,111,56,55,5.525,5.373,7,6
10,15,0,50,25,25,2.883,2.742,8,8
10,16,0,50,25,25,2.567,2.236,8,8
10,17,0,50,25,25,2.944,2.755,8,8
10,18,0,50,25,25,2.574,2.498,8,8
10,19,1,85,43,42,4.751,4.797,8,7
10,20,0,102,51,51,5.028,4.894,7,7
11,1,1,235,118,117,19.303,18.133,5,1
11,2,-1,176,88,88,9.905,10.026,5,7
11,3,-1,111,56,55,5.899,6.133,6,7
11,4,-1,62,31,31,3.017,2.853,7,8
11,5,1,187,94,93,10.691,10.005,5,4
11,6,0,107,54,53,5.529,5.369,7,7
11,7,1,133,67,66,7.265,6.831,8,6
11,8,1,57,29,28,3.055,2.864,8,7
11,9,0,50,25,25,2.372,2.303,8,8
11,10,1,133,67,66,7.365,6.952,8,3
11,11,1,135,68,67,7.243,7.292,8,2
11,12,1,93,47,46,5.279,5.094,7,6
11,13,1,153,77,76,8.116,7.763,4,0
11,14,1,137,69,68,7.111,6.984,6,3
11,15,-1,185,93,92,9.854,9.758,3,5
11,16,0,50,25,25,2.86,2.934,8,8
11,17,-1,110,55,55,6.036,5.929,5,6
11,18,1,171,86,85,8.837,8.739,6,4
11,19,-1,230,115,115,12.086,11.807,2,4
11,20,1,101,51,50,5.106,4.614,8,5
12,1,0,50,25,25,2.303,2.231,8,8
12,2,-1,126,63,63,6.888,6.647,2,7
12,3,0,76,38,38,4.381,4.229,7,7
12,4,1,89,45,44,4.965,4.603,7,5
12,5,0,50,25,25,2.542,2.447,8,8
12,6,1,169,85,84,8.623,8.348,5,4
12,7,1,57,29,28,3.336,3.391,8,7
12,8,1,89,45,44,4.421,4.226,8,6
12,9,-1,114,57,57,6.189,6.094,5,7
12,10,0,50,25,25,2.512,2.483,8,8
12,11,0,113,57,56,5.944,5.974,5,5
12,12,1,69,35,34,3.936,3.853,8,7
12,13,1,59,30,29,2.803,2.652,8,7
12,14,1,145,73,72,7.895,7.541,7,6
12,15,0,50,25,25,3.143,3.101,8,8
12,16,1,193,97,96,10.109,9.627,7,4
12,17,0,50,25,25,2.573,2.722,8,8
12,18,1,189,95,94,9.935,9.739,2,1
12,19,0,50,25,25,2.384,2.318,8,8
12,20,0,50,25,25,2.826,2.979,8,8
13,1,1,57,29,28,3.512,3.359,8,7
13,2,0,100,50,50,5.273,5.098,7,7
13,3,1,73,37,36,4.023,3.667,8,7
13,4,1,59,30,29,3.194,3.075,8,7
13,5,0,50,25,25,2.742,2.64,8,8
13,6,1,105,53,52,6.104,5.704,7,6
13,7,1,159,80,79,8.5,8.01,6,4
13,8,0,50,25,25,2.363,2.215,8,8
13,9,0,50,25,25,2.865,2.829,8,8
13,10,-1,74,37,37,3.876,3.612,7,8
13,11,1,155,78,77,8.065,7.914,6,4
13,12,-1,170,85,85,9.008,9.187,3,5
13,13,0,88,44,44,4.789,4.393,7,7
13,14,1,77,39,38,4.475,4.377,8,7
13,15,1,81,41,40,4.109,3.798,8,7
13,16,1,149,75,74,7.794,7.848,4,3
13,17,1,82,41,41,4.405,4.513,7,6
13,18,-1,200,100,100,10.402,10.547,1,3
13,19,1,155,78,77,8.479,8.137,7,0
13,20,1,63,32,31,3.278,2.916,8,7
14,1,0,98,49,49,5.432,5.236,6,6
14,2,1,215,108,107,11.006,10.479,5,2
14,3,1,207,104,103,11.523,10.945,5,2
14,4,0,50,25,25,2.497,2.2,8,8
14,5,0,50,25,25,2.853,2.799,8,8
14,6,0,50,25,25,2.612,2.482,8,8
14,7,1,63,32,31,3.027,2.972,8,7
14,8,0,99,50,49,5.35,5.435,7,7
14,9,1,217,109,108,11.797,11.263,6,3
14,10,1,61,31,30,2.916,2.75,8,7
14,11,0,50,25,25,2.631,2.527,8,8
14,12,0,97,49,48,4.814,4.884,6,6
14,13,1,224,112,112,11.94,11.445,4,2
14,14,1,121,61,60,6.494,6.248,7,6
14,15,0,50,25,25,2.505,2.205,8,8
14,16,-1,103,52,51,5.656,5.431,6,7
14,17,0,50,25,25,2.359,2.252,8,8
14,18,1,103,52,51,5.781,5.317,7,5
14,19,-1,160,80,80,7.955,8.029,1,2
14,20,0,79,40,39,4.453,4.23,7,7
15,1,0,50,25,25,2.341,2.258,8,8
15,2,0,50,25,25,2.31,2.29,8,8
15,3,0,68,34,34,4.067,3.696,7,7
15,4,-1,58,29,29,2.781,2.605,7,8
15,5,-1,154,77,77,8.351,8.498,3,8
15,6,0,94,47,47,5.27,5.032,7,7
15,7,0,50,25,25,3.576,3.242,8,8
15,8,1,293,147,146,16.639,16.495,2,1
15,9,-1,78,39,39,3.847,3.816,7,8
15,10,1,161,81,80,8.844,8.489,6,4
15,11,0,80,40,40,4.093,3.742,7,7
15,12,0,92,46,46,5.113,4.977,7,7
15,13,1,63,32,31,2.991,3.068,8,6
15,14,0,50,25,25,3.158,3.068,8,8
15,15,1,69,35,34,3.293,3.21,8,7
15,16,1,59,30,29,3.698,3.391,8,7
15,17,0,50,25,25,2.348,2.254,8,8
15,18,1,177,89,88,9.072,8.892,7,1
15,19,1,65,33,32,3.717,3.688,8,6
15,20,1,59,30,29,2.715,2.841,8,7
16,1,1,79,40,39,3.762,3.656,8,6
16,2,1,135,68,67,6.412,5.728,7,5
16,3,1,86,43,43,4.641,4.281,7,4
16,4,1,155,78,77,7.131,7.125,8,3
16,5,0,61,31,30,2.727,2.89,7,7
16,6,0,50,25,25,2.539,2.417,8,8
16,7,1,167,84,83,7.347,7.205,3,1
16,8,-1,192,96,96,8.686,8.354,0,3
16,9,-1,139,70,69,6.565,6.471,3,7
16,10,-1,236,118,118,11.127,11.045,0,4
16,11,0,126,63,63,5.573,5.154,6,6
16,12,0,50,25,25,2.575,2.476,8,8
16,13,1,57,29,28,2.406,2.25,8,7
16,14,0,98,49,49,4.837,4.716,7,7
16,15,0,50,25,25,2.039,2.04,8,8
16,16,0,50,25,25,2.279,2.161,8,8
16,17,1,211,106,105,10.125,10.116,3,2
16,18,1,83,42,41,3.8,3.93,7,6
16,19,-1,130,65,65,5.676,5.715,0,6
16,20,0,50,25,25,2.749,2.603,8,8
17,1,0,50,25,25,3.039,2.577,8,8
17,2,0,50,25,25,2.149,2.006,8,8
17,3,1,67,34,33,3.266,3.133,8,7
17,4,0,50,25,25,2.268,2.389,8,8
17,5,-1,128,64,64,5.723,5.689,3,4
17,6,-1,124,62,62,6.02,5.558,6,7
17,7,1,63,32,31,2.717,2.584,8,7
17,8,-1,190,95,95,8.187,8.535,3,5
17,9,0,50,25,25,2.506,2.656,8,8
17,10,-1,126,63,63,5.188,5.15,4,5
17,11,0,50,25,25,2.706,2.581,8,8
17,12,0,90,45,45,3.905,3.669,7,7
17,13,-1,222,111,111,10.388,10.12,1,5
17,14,1,89,45,44,3.601,3.493,8,6
17,15,1,67,34,33,3.42,3.447,8,7
17,16,1,61,31,30,2.482,2.38,8,7
17,17,0,50,25,25,2.425,2.34,8,8
17,18,1,81,41,40,3.599,3.437,7,6
17,19,0,50,25,25,2.211,1.923,8,8
17,20,1,222,111,111,10.474,9.933,5,2
18,1,0,50,25,25,2.177,2.196,8,8
18,2,1,163,82,81,7.31,7.499,7,3
18,3,0,50,25,25,1.944,1.882,8,8
18,4,-1,208,104,104,9.37,9.511,1,3
18,5,0,50,25,25,2.239,1.968,8,8
18,6,0,50,25,25,2.016,1.936,8,8
18,7,0,50,25,25,2.656,2.584,8,8
18,8,1,173,87,86,7.875,7.59,5,3
18,9,-1,178,89,89,7.843,7.957,0,5
18,10,0,113,57,56,5.289,5.354,6,6
18,11,1,194,97,97,8.874,8.363,5,2
18,12,0,50,25,25,2.02,1.965,8,8
18,13,0,50,25,25,2.771,2.574,8,8
18,14,0,50,25,25,1.984,1.872,8,8
18,15,1,168,84,84,7.364,7.405,6,3
18,16,0,140,70,70,6.628,6.273,6,6
18,17,1,127,64,63,6.027,5.968,7,6
18,18,0,50,25,25,2.128,1.993,8,8
18,19,0,115,58,57,5.469,5.321,7,7
18,20,1,175,88,87,7.757,7.626,6,4
19,1,0,87,44,43,3.913,4.222,7,7
19,2,0,50,25,25,2.279,2.219,8,8
19,3,0,191,96,95,8.393,8.528,4,4
19,4,0,50,25,25,2.191,2.36,8,8
19,5,-1,128,64,64,5.7,5.689,2,6
19,6,0,50,25,25,2.702,2.886,8,8
19,7,1,83,42,41,3.497,3.385,8,7
19,8,1,211,106,105,9.961,9.88,5,1
19,9,1,146,73,73,6.518,6.576,6,4
19,10,0,50,25,25,2.217,2.048,8,8
19,11,0,83,42,41,3.511,3.565,6,6
19,12,1,61,31,30,3.06,2.949,8,7
19,13,1,91,46,45,3.857,3.675,8,7
19,14,0,50,25,25,2.8,2.48,8,8
19,15,1,93,47,46,3.802,3.679,2,0
19,16,0,117,59,58,5.755,5.779,7,7
19,17,1,181,91,90,8.125,7.918,7,1
19,18,-1,71,36,35,3.736,3.503,6,7
19,19,1,146,73,73,6.793,6.568,7,6
19,20,0,50,25,25,2.301,1.995,8,8
20,1,0,50,25,25,2.53,2.458,8,8
20,2,1,67,34,33,3.004,2.936,8,6
20,3,1,61,31,30,2.741,2.477,8,7
20,4,-1,164,82,82,7.694,7.646,3,5
20,5,1,147,74,73,6.96,6.943,7,5
20,6,1,93,47,46,4.402,4.052,8,5
20,7,1,223,112,111,10.652,10.481,5,0
20,8,1,137,69,68,6.062,5.794,7,3
20,9,1,122,61,61,5.668,5.223,7,5
20,10,0,50,25,25,2.826,2.572,8,8
20,11,-1,172,86,86,7.794,7.906,2,6
20,12,1,149,75,74,6.925,6.869,6,4
20,13,-1,100,50,50,4.363,4.29,5,7
20,14,1,239,120,119,10.945,10.923,4,1
20,15,1,67,34,33,3.208,2.852,8,7
20,16,1,161,81,80,7.521,7.388,7,4
20,17,-1,196,98,98,9.08,8.828,2,3
20,18,-1,234,117,117,9.943,10.365,2,4
20,19,-1,95,48,47,4.429,4.825,5,6
20,20,1,189,95,94,8.877,8.344,7,0
21,1,1,147,74,73,7.491,7.257,8,4
21,2,0,50,25,25,2.669,2.661,8,8
21,3,0,109,55,54,4.901,4.994,7,7
21,4,1,93,47,46,4.747,4.533,7,6
21,5,-1,146,73,73,6.988,7.086,0,6
21,6,1,125,63,62,6.147,5.887,5,3
21,7,0,50,25,25,2.057,2.225,8,8
21,8,1,85,43,42,4.475,4.301,7,6
21,9,0,50,25,25,2.172,2.133,8,8
21,10,1,327,164,163,15.454,14.994,2,0
21,11,-1,126,63,63,5.933,6.606,2,7
21,12,-1,157,79,78,7.227,7.568,2,5
21,13,0,50,25,25,2.679,2.565,8,8
21,14,0,50,25,25,2.352,2.188,8,8
21,15,0,50,25,25,2.343,2.094,8,8
21,16,-1,141,71,70,6.526,6.659,5,7
21,17,0,50,25,25,2.575,2.58,8,8
21,18,1,65,33,32,3.068,3.063,8,7
21,19,1,103,52,51,5.255,5.27,7,6
21,20,1,95,48,47,4.268,4.134,7,6
22,1,1,156,78,78,7.762,7.188,6,5
22,2,1,111,56,55,5.293,5.088,8,5
22,3,0,78,39,39,3.665,3.273,7,7
22,4,0,50,25,25,2.12,2.109,8,8
22,5,-1,124,62,62,5.723,5.957,3,5
22,6,1,200,100,100,10.134,9.584,6,5
22,7,1,155,78,77,7.557,7.016,6,4
22,8,0,68,34,34,2.83,2.924,7,7
22,9,-1,199,100,99,9.13,9.114,4,5
22,10,1,259,130,129,12.251,11.767,2,1
22,11,1,111,56,55,5.478,5.563,8,6
22,12,0,50,25,25,2.087,2.08,8,8
22,13,-1,184,92,92,9.268,9.615,1,8
22,14,0,50,25,25,2.365,2.024,8,8
22,15,1,77,39,38,3.382,3.219,8,7
22,16,1,181,91,90,8.717,8.618,5,1
22,17,0,141,71,70,6.395,6.234,4,4
22,18,0,50,25,25,2.321,2.05,8,8
22,19,0,127,64,63,6.057,5.732,7,7
22,20,0,50,25,25,1.997,1.889,8,8
23,1,-1,148,74,74,6.902,6.832,0,6
23,2,0,50,25,25,2.979,2.697,8,8
23,3,0,98,49,49,3.947,3.832,7,7
23,4,1,119,60,59,5.683,5.438,5,1
23,5,1,97,49,48,4.826,4.517,7,5
23,6,1,209,105,104,10.584,9.751,6,5
23,7,1,83,42,41,4.502,4.524,8,7
23,8,0,75,38,37,3.365,3.387,6,6
23,9,-1,64,32,32,3.33,3.239,7,8
23,10,-1,132,66,66,6.588,6.366,2,6
23,11,0,112,56,56,5.768,5.321,7,7
23,12,0,50,25,25,2.155,2.098,8,8
23,13,0,50,25,25,2.1,1.989,8,8
23,14,1,73,37,36,4.032,3.703,8,6
23,15,1,249,125,124,11.872,11.282,6,1
23,16,1,134,67,67,6.272,5.725,7,6
23,17,1,81,41,40,4.02,3.799,8,6
23,18,1,91,46,45,4.64,4.289,7,6
23,19,1,101,51,50,4.251,4.119,7,6
23,20,0,50,25,25,2.788,2.687,8,8
24,1,0,50,25,25,2.266,2.048,8,8
24,2,0,50,25,25,2.807,2.634,8,8
24,3,-1,64,32,32,2.704,2.614,7,8
24,4,-1,70,35,35,3.337,3.587,6,7
24,5,0,50,25,25,2.34,2.166,8,8
24,6,0,50,25,25,2.085,2.012,8,8
24,7,1,102,51,51,4.954,5.093,7,6
24,8,0,50,25,25,2.146,2.017,8,8
24,9,1,63,32,31,3.354,3.224,8,7
24,10,1,81,41,40,3.464,3.616,8,7
24,11,-1,142,71,71,6.67,6.882,3,6
24,12,-1,125,63,62,5.821,6.114,6,7
24,13,1,79,40,39,4.053,3.821,8,7
24,14,1,87,44,43,3.784,3.621,7,6
24,15,-1,68,34,34,3.487,3.621,7,8
24,16,-1,64,32,32,2.669,2.57,7,8
24,17,-1,74,37,37,3.733,3.691,7,8
24,18,-1,254,127,127,11.515,11.391,2,4
24,19,1,87,44,43,4.4,4.449,8,5
24,20,0,84,42,42,4.03,3.847,7,7
25,1,1,71,36,35,3.346,2.97,8,6
25,2,-1,198,99,99,9.818,9.93,0,4
25,3,-1,119,60,59,5.65,5.818,4,5
25,4,0,60,30,30,2.552,2.507,7,7
25,5,1,83,42,41,4.54,4.126,7,6
25,6,1,106,53,53,4.564,4.407,7,6
25,7,0,50,25,25,2.782,2.64,8,8
25,8,1,93,47,46,4.055,4.005,8,6
25,9,-1,90,45,45,4.403,4.486,4,7
25,10,0,50,25,25,2.37,2.073,8,8
25,11,0,50,25,25,2.832,2.779,8,8
25,12,1,147,74,73,7.242,6.944,7,6
25,13,1,287,144,143,13.562,13.276,5,1
25,14,0,50,25,25,2.085,2.113,8,8
25,15,0,50,25,25,2.116,2.046,8,8
25,16,0,93,47,46,4.643,4.655,5,5
25,17,0,50,25,25,2.137,1.978,8,8
25,18,-1,162,81,81,7.457,7.439,2,7
25,19,0,50,25,25,2.725,2.666,8,8
25,20,1,217,109,108,9.945,9.637,5,0
26,1,1,113,57,56,5.476,5.06,6,4
26,2,-1,178,89,89,8.667,8.504,0,6
26,3,0,120,60,60,5.698,5.663,6,6
26,4,0,50,25,25,2.357,2.25,8,8
26,5,1,81,41,40,3.862,3.556,7,5
26,6,-1,198,99,99,9.677,9.682,0,6
26,7,0,50,25,25,2.118,1.993,8,8
26,8,1,77,39,38,4.101,3.959,8,7
26,9,0,50,25,25,2.044,2.212,8,8
26,10,1,85,43,42,4.44,4.325,8,7
26,11,1,71,36,35,3.12,2.932,8,7
26,12,1,99,50,49,4.916,5.113,6,5
26,13,-1,160,80,80,7.767,7.662,0,6
26,14,-1,174,87,87,8.275,8.319,1,5
26,15,1,119,60,59,5.993,5.813,7,6
26,16,1,73,37,36,3.386,3.515,8,6
26,17,0,50,25,25,2.649,2.604,8,8
26,18,1,69,35,34,3.058,2.91,8,7
26,19,-1,125,63,62,6.483,6.241,3,6
26,20,1,157,79,78,7.347,7.689,4,3
27,1,1,207,104,103,9.562,9.293,5,2
27,2,1,59,30,29,2.486,2.386,8,7
27,3,-1,181,91,90,8.851,8.951,4,6
27,4,-1,202,101,101,9.255,9.387,0,3
27,5,-1,146,73,73,6.707,6.664,1,3
27,6,1,231,116,115,11.664,11.002,5,2
27,7,1,67,34,33,3.132,2.793,8,7
27,8,0,50,25,25,2.096,2.093,8,8
27,9,0,60,30,30,3.229,3.207,7,7
27,10,1,224,112,112,10.445,9.852,5,3
27,11,1,81,41,40,4.498,4.096,8,7
27,12,1,205,103,102,9.404,9.732,5,3
27,13,-1,240,120,120,11.466,11.249,0,3
27,14,-1,208,104,104,9.414,9.275,1,2
27,15,1,215,108,107,10.59,10.516,5,1
27,16,1,91,46,45,3.9,3.984,8,6
27,17,-1,254,127,127,11.874,12.326,1,6
27,18,1,191,96,95,8.8,9.208,4,3
27,19,1,141,71,70,6.823,6.769,7,5
27,20,-1,195,98,97,9.621,9.97,2,5
28,1,-1,140,70,70,6.637,6.604,3,5
28,2,-1,82,41,41,4.213,4.455,6,8
28,3,0,72,36,36,3.043,3.051,7,7
28,4,1,125,63,62,6.342,5.863,7,5
28,5,1,107,54,53,5.321,5.289,5,4
28,6,0,50,25,25,2.355,2.042,8,8
28,7,1,139,70,69,6.74,6.584,4,1
28,8,0,50,25,25,2.207,2.155,8,8
28,9,0,50,25,25,3.08,2.777,8,8
28,10,0,94,47,47,4.226,4.044,7,7
28,11,1,85,43,42,4.556,4.66,8,7
28,12,1,83,42,41,4.336,4.197,8,7
28,13,0,50,25,25,2.307,2.154,8,8
28,14,1,141,71,70,7.037,6.844,5,4
28,15,0,50,25,25,2.161,2.014,8,8
28,16,1,144,72,72,6.907,6.891,6,3
28,17,1,211,106,105,10.753,10.629,6,2
28,18,1,77,39,38,3.675,3.396,8,7
28,19,1,153,77,76,7.521,7.152,6,3
28,20,1,69,35,34,3.83,3.691,8,7
29,1,-1,226,113,113,11.249,11.468,1,2
29,2,-1,172,86,86,8.44,8.242,4,7
29,3,0,50,25,25,2.167,2.09,8,8
29,4,1,143,72,71,7.382,6.994,7,5
29,5,1,97,49,48,4.968,5.276,7,6
29,6,1,229,115,114,11.144,11.768,2,0
29,7,1,195,98,97,9.247,9.062,4,2
29,8,0,50,25,25,2.151,2.323,8,8
29,9,0,50,25,25,2.971,2.922,8,8
29,10,1,119,60,59,5.903,5.667,7,0
29,11,0,102,51,51,4.907,4.768,7,7
29,12,0,50,25,25,2.607,2.538,8,8
29,13,1,57,29,28,2.97,2.57,8,7
29,14,0,50,25,25,2.086,2.083,8,8
29,15,-1,102,51,51,5.205,5.376,5,7
29,16,0,50,25,25,2.357,2.349,8,8
29,17,0,50,25,25,2.845,2.836,8,8
29,18,1,67,34,33,3.17,2.919,8,6
29,19,0,111,56,55,5.934,5.744,7,7
29,20,1,209,105,104,10.58,10.149,3,0
30,1,0,50,25,25,2.223,2.063,8,8
30,2,1,61,31,30,3.473,3.11,8,7
30,3,1,101,51,50,4.643,4.527,8,6
30,4,0,81,41,40,4.543,4.325,7,7
30,5,1,81,41,40,3.77,3.565,8,7
30,6,-1,129,65,64,6.241,6.371,4,7
30,7,0,83,42,41,4.393,4.182,7,7
30,8,1,63,32,31,2.976,2.675,8,6
30,9,0,50,25,25,2.877,2.746,8,8
30,10,0,50,25,25,2.223,2.068,8,8
30,11,0,50,25,25,2.17,2.274,8,8
30,12,-1,74,37,37,4.113,3.919,7,8
30,13,1,63,32,31,2.779,2.69,8,7
30,14,0,50,25,25,2.892,2.955,8,8
30,15,-1,66,33,33,2.947,2.828,7,8
30,16,-1,128,64,64,6.051,6.481,1,8
30,17,1,61,31,30,2.862,2.808,8,7
30,18,-1,112,56,56,5.245,5.202,0,4
30,19,1,61,31,30,3.401,3.491,8,7
30,20,0,117,59,58,5.659,5.625,7,7
31,1,0,50,25,25,2.868,2.677,8,8
31,2,0,50,25,25,2.097,1.972,8,8
31,3,0,50,25,25,2.454,2.695,8,8
31,4,0,50,25,25,2.814,2.781,8,8
31,5,0,50,25,25,2.104,2.051,8,8
31,6,1,127,64,63,6.102,6.129,5,3
31,7,1,79,40,39,3.635,3.483,8,7
31,8,0,50,25,25,2.778,2.511,8,8
31,9,-1,102,51,51,4.768,4.777,5,7
31,10,1,99,50,49,4.819,4.414,8,6
31,11,1,120,60,60,5.79,5.752,5,3
31,12,0,50,25,25,2.12,2.017,8,8
31,13,1,57,29,28,3.485,2.972,8,7
31,14,1,105,53,52,4.963,4.781,8,6
31,15,-1,106,53,53,5.084,4.823,4,7
31,16,0,114,57,57,5.746,5.767,7,7
31,17,-1,191,96,95,8.875,9.085,2,3
31,18,1,105,53,52,5.657,5.394,8,6
31,19,0,50,25,25,2.449,2.46,8,8
31,20,1,155,78,77,7.893,8.149,5,0
32,1,0,50,25,25,2.139,2.122,8,8
32,2,1,109,55,54,5.552,5.43,8,6
32,3,1,71,36,35,3.905,4.002,8,7
32,4,0,50,25,25,2.253,2.04,8,8
32,5,-1,226,113,113,10.838,11.146,1,3
32,6,-1,68,34,34,3.258,3.164,7,8
32,7,0,100,50,50,4.982,5.199,7,7
32,8,1,151,76,75,7.675,7.486,5,4
32,9,-1,138,69,69,6.803,6.606,0,6
32,10,1,57,29,28,2.587,2.721,8,7
32,11,0,50,25,25,2.331,2.239,8,8
32,12,1,61,31,30,3.271,3.155,8,7
32,13,0,50,25,25,2.089,2.052,8,8
32,14,0,71,36,35,3.832,3.89,7,7
32,15,1,73,37,36,3.078,2.951,8,7
32,16,1,129,65,64,6.641,6.293,8,4
32,17,1,99,50,49,5.07,4.985,7,5
32,18,1,161,81,80,7.942,7.397,7,1
32,19,1,57,29,28,2.791,2.392,8,7
32,20,0,50,25,25,2.806,2.795,8,8
33,1,0,50,25,25,2.236,2.153,8,8
33,2,0,50,25,25,2.858,2.807,8,8
33,3,-1,338,169,169,15.963,16.128,1,2
33,4,1,117,59,58,5.743,5.638,6,4
33,5,0,62,31,31,2.712,2.521,7,7
33,6,0,50,25,25,2.711,2.786,8,8
33,7,0,50,25,25,2.331,2.157,8,8
33,8,-1,120,60,60,6.104,5.663,4,6
33,9,0,50,25,25,2.091,2.0,8,8
33,10,1,131,66,65,6.305,6.023,6,4
33,11,1,75,38,37,3.473,3.687,8,7
33,12,0,50,25,25,2.629,2.63,8,8
33,13,0,50,25,25,2.244,2.232,8,8
33,14,0,50,25,25,2.527,2.705,8,8
33,15,0,50,25,25,2.421,2.419,8,8
33,16,0,50,25,25,2.119,2.022,8,8
33,17,0,50,25,25,2.652,2.522,8,8
33,18,1,63,32,31,3.351,2.944,8,7
33,19,0,50,25,25,2.256,2.115,8,8
33,20,1,55,28,27,3.108,3.007,8,7
34,1,-1,172,86,86,8.289,7.898,0,3
34,2,-1,222,111,111,10.921,11.258,2,5
34,3,1,59,30,29,2.588,2.543,8,7
34,4,-1,96,48,48,5.017,4.606,7,8
34,5,1,217,109,108,10.754,10.667,5,4
34,6,-1,110,55,55,5.857,5.777,5,7
34,7,-1,119,60,59,5.892,6.142,4,7
34,8,1,73,37,36,3.693,3.841,8,6
34,9,-1,188,94,94,9.161,9.354,0,5
34,10,-1,155,78,77,7.397,7.888,2,3
34,11,1,141,71,70,6.97,7.18,7,5
34,12,-1,84,42,42,4.21,3.98,7,8
34,13,0,50,25,25,2.762,2.627,8,8
34,14,1,127,64,63,6.785,6.197,7,6
34,15,-1,122,61,61,6.168,6.332,4,5
34,16,1,123,62,61,5.895,5.788,8,5
34,17,-1,158,79,79,8.238,8.09,1,5
34,18,-1,62,31,31,2.872,2.77,7,8
34,19,1,69,35,34,4.128,3.787,8,7
34,20,-1,210,105,105,10.441,10.521,2,3
35,1,0,50,25,25,2.745,2.857,8,8
35,2,0,50,25,25,2.3,2.286,8,8
35,3,1,237,119,118,12.311,12.408,3,1
35,4,1,73,37,36,3.481,3.35,8,7
35,5,0,50,25,25,2.825,2.75,8,8
35,6,1,129,65,64,6.666,6.786,7,6
35,7,0,50,25,25,2.242,2.25,8,8
35,8,1,87,44,43,4.818,4.91,8,6
35,9,-1,179,90,89,8.849,8.818,3,6
35,10,0,50,25,25,2.215,2.312,8,8
35,11,0,50,25,25,2.884,2.817,8,8
35,12,1,222,111,111,10.949,10.386,4,2
35,13,1,77,39,38,4.2,4.412,7,6
35,14,1,69,35,34,3.149,3.0,8,7
35,15,0,50,25,25,3.176,2.807,8,8
35,16,0,50,25,25,2.277,2.144,8,8
35,17,1,153,77,76,7.914,7.415,6,4
35,18,0,144,72,72,7.185,6.896,5,5
35,19,1,199,100,99,10.304,10.274,5,2
35,20,-1,152,76,76,7.428,7.703,0,7
36,1,1,117,59,58,6.164,5.79,6,5
36,2,0,50,25,25,2.36,2.238,8,8
36,3,-1,166,83,83,8.045,8.075,3,5
36,4,0,104,52,52,4.374,4.184,7,7
36,5,1,205,103,102,10.276,9.738,6,2
36,6,1,83,42,41,3.802,3.504,8,6
36,7,0,98,49,49,4.885,4.756,6,6
36,8,-1,188,94,94,8.739,8.587,3,4
36,9,1,142,71,71,6.714,6.582,6,5
36,10,-1,134,67,67,6.225,6.256,5,6
36,11,-1,152,76,76,7.258,6.95,2,4
36,12,1,115,58,57,5.619,5.444,7,5
36,13,-1,168,84,84,8.356,7.85,3,6
36,14,1,67,34,33,3.319,3.176,8,6
36,15,0,50,25,25,2.454,2.319,8,8
36,16,1,179,90,89,8.615,8.133,6,3
36,17,0,50,25,25,2.259,2.123,8,8
36,18,0,50,25,25,2.792,2.651,8,8
36,19,0,50,25,25,2.349,2.048,8,8
36,20,0,50,25,25,2.232,2.136,8,8
37,1,0,50,25,25,2.114,1.986,8,8
37,2,0,50,25,25,2.643,2.46,8,8
37,3,-1,137,69,68,6.194,6.048,4,5
37,4,0,50,25,25,2.791,2.706,8,8
37,5,1,135,68,67,6.564,6.391,8,5
37,6,0,258,129,129,11.813,11.129,2,2
37,7,0,50,25,25,2.866,2.654,8,8
37,8,1,69,35,34,2.909,3.009,7,6
37,9,0,50,25,25,2.741,2.652,8,8
37,10,0,107,54,53,5.045,4.597,6,6
37,11,-1,198,99,99,9.532,10.062,1,6
37,12,1,217,109,108,9.935,9.89,2,1
37,13,1,57,29,28,2.874,2.968,8,7
37,14,-1,102,51,51,4.613,4.508,4,8
37,15,1,86,43,43,4.256,4.5,6,5
37,16,0,50,25,25,2.125,1.973,8,8
37,17,0,50,25,25,2.448,2.47,8,8
37,18,1,143,72,71,6.954,6.871,7,5
37,19,0,50,25,25,2.602,2.412,8,8
37,20,-1,140,70,70,6.962,7.048,2,4
38,1,0,79,40,39,4.17,4.119,6,6
38,2,1,109,55,54,5.107,5.14,7,5
38,3,1,151,76,75,7.637,7.074,5,4
38,4,0,50,25,25,2.242,2.166,8,8
38,5,1,171,86,85,8.641,8.163,7,5
38,6,0,50,25,25,2.491,2.444,8,8
38,7,-1,74,37,37,3.827,3.694,7,8
38,8,-1,186,93,93,8.868,8.987,0,6
38,9,1,105,53,52,5.711,5.281,8,5
38,10,-1,138,69,69,6.452,6.555,0,7
38,11,1,75,38,37,3.839,4.029,8,7
38,12,0,50,25,25,2.318,2.199,8,8
38,13,-1,102,51,51,5.064,5.377,4,7
38,14,0,106,53,53,4.677,4.453,7,7
38,15,0,90,45,45,4.682,4.768,7,7
38,16,0,81,41,40,4.019,3.819,7,7
38,17,1,327,164,163,16.138,15.066,2,1
38,18,-1,137,69,68,7.005,6.519,6,7
38,19,0,63,32,31,2.617,2.626,7,7
38,20,-1,131,66,65,6.541,6.308,6,7
39,1,0,97,49,48,4.857,4.598,7,7
39,2,0,50,25,25,2.658,2.548,8,8
39,3,0,65,33,32,3.305,2.905,7,7
39,4,-1,54,27,27,2.449,2.329,7,8
39,5,0,50,25,25,2.875,2.819,8,8
39,6,1,79,40,39,3.777,3.357,8,6
39,7,0,50,25,25,2.921,2.88,8,8
39,8,1,187,94,93,8.927,8.789,8,2
39,9,0,84,42,42,4.414,3.994,7,7
39,10,0,50,25,25,2.439,2.388,8,8
39,11,-1,143,72,71,6.858,6.857,5,7
39,12,1,219,110,109,10.262,9.887,5,2
39,13,0,88,44,44,4.458,4.395,7,7
39,14,1,81,41,40,3.934,4.124,8,6
39,15,1,115,58,57,5.248,5.177,8,6
39,16,0,50,25,25,2.981,2.725,8,8
39,17,0,50,25,25,2.09,2.048,8,8
39,18,1,161,81,80,7.751,7.406,7,5
39,19,1,61,31,30,3.094,3.0,8,7
39,20,1,93,47,46,4.222,3.981,7,6
40,1,1,67,34,33,3.065,3.251,8,7
40,2,1,94,47,47,4.749,4.512,7,6
40,3,-1,72,36,36,3.495,3.136,7,8
40,4,0,50,25,25,2.817,2.72,8,8
40,5,-1,186,93,93,8.696,8.721,1,8
40,6,-1,156,78,78,7.227,7.429,2,4
40,7,1,137,69,68,6.715,6.522,6,4
40,8,0,50,25,25,2.111,2.335,8,8
40,9,-1,106,53,53,5.185,5.329,4,7
40,10,1,153,77,76,7.239,7.14,6,3
40,11,0,50,25,25,2.164,2.058,8,8
40,12,0,50,25,25,3.024,2.64,8,8
40,13,1,220,110,110,9.898,9.803,4,2
40,14,0,50,25,25,2.482,2.456,8,8
40,15,1,59,30,29,2.78,2.678,8,6
40,16,0,50,25,25,2.354,2.084,8,8
40,17,1,117,59,58,5.759,5.569,7,5
40,18,-1,120,60,60,5.801,5.926,4,6
40,19,0,50,25,25,2.094,2.111,8,8
40,20,-1,214,107,107,10.418,10.508,1,5
41,1,0,50,25,25,2.197,2.125,8,8
41,2,0,50,25,25,2.548,2.437,8,8
41,3,-1,200,100,100,9.516,10.416,0,3
41,4,0,144,72,72,6.99,7.004,7,7
41,5,1,69,35,34,3.303,3.19,8,7
41,6,0,50,25,25,3.011,2.613,8,8
41,7,-1,70,35,35,3.015,3.036,6,8
41,8,1,195,98,97,9.981,9.995,3,2
41,9,0,76,38,38,3.418,3.29,7,7
41,10,0,50,25,25,2.85,2.755,8,8
41,11,1,135,68,67,6.889,6.333,6,4
41,12,-1,324,162,162,16.158,16.158,1,2
41,13,1,61,31,30,2.772,2.635,8,6
41,14,0,50,25,25,2.926,3.036,8,8
41,15,1,171,86,85,8.448,8.62,5,4
41,16,0,88,44,44,4.322,4.216,7,7
41,17,1,215,108,107,10.435,10.44,3,0
41,18,1,139,70,69,7.13,6.898,7,6
41,19,1,259,130,129,13.046,12.728,4,0
41,20,0,96,48,48,4.965,5.053,7,7
42,1,1,99,50,49,5.054,4.966,7,4
42,2,1,235,118,117,11.19,10.739,4,0
42,3,-1,162,81,81,7.744,7.961,1,4
42,4,1,115,58,57,5.801,5.613,6,5
42,5,1,183,92,91,9.265,8.827,5,2
42,6,1,153,77,76,8.177,7.755,6,5
42,7,0,50,25,25,2.166,2.086,8,8
42,8,-1,91,46,45,4.931,4.701,6,7
42,9,0,87,44,43,4.021,3.771,7,7
42,10,1,59,30,29,3.569,3.171,8,7
42,11,0,113,57,56,5.571,5.398,7,7
42,12,0,50,25,25,2.786,2.705,8,8
42,13,0,50,25,25,2.229,2.345,8,8
42,14,-1,190,95,95,9.957,9.697,4,5
42,15,0,50,25,25,3.041,2.691,8,8
42,16,0,91,46,45,5.567,5.274,7,7
42,17,1,251,126,125,12.883,12.77,5,0
42,18,-1,212,106,106,10.324,10.485,0,2
42,19,0,50,25,25,2.316,2.25,8,8
42,20,1,91,46,45,4.783,4.899,8,7
43,1,1,235,118,117,11.903,11.483,2,1
43,2,1,77,39,38,4.024,3.917,7,5
43,3,-1,148,74,74,7.416,7.318,0,5
43,4,-1,110,55,55,4.848,4.661,0,4
43,5,1,185,93,92,9.622,9.561,6,5
43,6,-1,126,63,63,6.386,6.6,6,8
43,7,-1,208,104,104,9.542,9.883,1,4
43,8,1,59,30,29,2.922,2.693,8,7
43,9,-1,136,68,68,6.492,6.756,0,6
43,10,1,221,111,110,11.361,10.762,5,0
43,11,1,73,37,36,3.509,3.478,8,7
43,12,-1,142,71,71,6.784,7.107,0,4
43,13,-1,93,47,46,4.297,4.39,4,7
43,14,1,245,123,122,11.999,11.98,5,1
43,15,1,71,36,35,3.401,3.009,8,7
43,16,0,50,25,25,2.797,2.729,8,8
43,17,1,93,47,46,4.167,3.958,8,7
43,18,0,50,25,25,2.867,3.094,8,8
43,19,0,50,25,25,2.146,2.091,8,8
43,20,1,165,83,82,8.126,8.215,5,3
44,1,1,89,45,44,4.383,4.108,8,7
44,2,1,59,30,29,3.552,3.155,8,7
44,3,1,101,51,50,4.62,4.283,8,6
44,4,-1,152,76,76,7.435,7.879,0,5
44,5,0,50,25,25,2.972,2.841,8,8
44,6,1,73,37,36,3.328,3.187,8,6
44,7,0,50,25,25,3.311,2.959,8,8
44,8,0,113,57,56,5.168,4.99,6,6
44,9,1,89,45,44,4.581,4.72,7,6
44,10,0,50,25,25,2.191,2.157,8,8
44,11,0,97,49,48,5.016,4.893,7,7
44,12,1,153,77,76,7.606,7.605,7,5
44,13,-1,88,44,44,4.581,4.579,5,7
44,14,0,50,25,25,2.297,2.437,8,8
44,15,1,143,72,71,7.151,6.886,5,3
44,16,0,94,47,47,5.345,4.779,7,7
44,17,1,87,44,43,4.14,4.101,8,6
44,18,0,50,25,25,2.634,2.839,8,8
44,19,0,50,25,25,2.306,2.173,8,8
44,20,0,100,50,50,5.532,5.116,7,7
45,1,1,165,83,82,7.983,7.84,5,3
45,2,0,144,72,72,7.523,6.987,3,3
45,3,-1,188,94,94,9.916,9.629,2,3
45,4,1,141,71,70,7.165,6.716,7,5
45,5,1,365,183,182,17.578,17.439,2,1
45,6,1,203,102,101,10.407,10.31,5,4
45,7,1,123,62,61,6.341,5.824,7,3
45,8,0,103,52,51,5.001,4.65,7,7
45,9,-1,56,28,28,3.135,3.256,7,8
45,10,0,50,25,25,2.153,2.077,8,8
45,11,0,98,49,49,5.394,5.141,7,7
45,12,-1,288,144,144,14.118,14.212,2,3
45,13,0,50,25,25,2.272,2.234,8,8
45,14,1,261,131,130,13.151,12.608,3,1
45,15,1,79,40,39,3.864,4.094,8,5
45,16,0,50,25,25,2.802,2.672,8,8
45,17,0,50,25,25,2.373,2.3,8,8
45,18,-1,234,117,117,11.918,12.172,2,3
45,19,1,253,127,126,13.296,12.667,6,2
45,20,-1,208,104,104,10.119,10.398,0,3
46,1,0,89,45,44,4.365,4.725,6,6
46,2,-1,220,110,110,11.838,11.863,2,3
46,3,1,59,30,29,7.029,6.757,8,7
46,4,1,183,92,91,9.78,9.419,4,0
46,5,-1,54,27,27,3.372,3.306,7,8
46,6,-1,264,132,132,14.403,14.207,2,4
46,7,1,245,123,122,13.499,13.155,3,1
46,8,1,151,76,75,8.479,7.998,6,4
46,9,0,50,25,25,2.526,2.443,8,8
46,10,-1,178,89,89,10.601,10.247,4,5
46,11,0,50,25,25,2.502,2.37,8,8
46,12,-1,58,29,29,3.769,3.606,7,8
46,13,1,57,29,28,2.857,2.981,8,7
46,14,-1,140,70,70,7.691,7.55,3,6
46,15,1,353,177,176,19.632,19.301,2,0
46,16,0,64,32,32,3.728,3.716,7,7
46,17,1,113,57,56,5.883,6.037,7,4
46,18,1,111,56,55,5.807,5.583,5,4
46,19,1,163,82,81,9.632,9.066,6,1
46,20,0,50,25,25,2.384,2.3,8,8
47,1,1,119,60,59,6.749,6.858,7,6
47,2,-1,80,40,40,4.098,3.838,7,8
47,3,0,50,25,25,3.384,3.09,8,8
47,4,1,249,125,124,13.591,13.058,4,1
47,5,1,110,55,55,5.632,5.45,6,5
47,6,1,129,65,64,7.931,7.493,7,6
47,7,-1,120,60,60,6.669,6.712,6,7
47,8,0,64,32,32,3.781,3.554,7,7
47,9,-1,76,38,38,4.384,4.533,5,8
47,10,0,50,25,25,2.438,2.393,8,8
47,11,0,146,73,73,8.146,7.857,2,2
47,12,0,50,25,25,3.279,3.159,8,8
47,13,0,50,25,25,2.747,2.404,8,8
47,14,1,249,125,124,14.299,13.54,7,2
47,15,0,50,25,25,2.698,2.639,8,8
47,16,1,115,58,57,6.582,6.168,7,5
47,17,-1,201,101,100,10.816,10.949,2,3
47,18,1,137,69,68,7.795,7.373,8,3
47,19,0,50,25,25,2.942,2.931,8,8
47,20,-1,156,78,78,8.873,8.63,2,4
48,1,0,50,25,25,2.718,2.494,8,8
48,2,1,143,72,71,7.968,8.023,5,0
48,3,1,137,69,68,7.652,7.549,7,6
48,4,1,59,30,29,3.975,3.59,8,7
48,5,0,50,25,25,2.435,2.443,8,8
48,6,-1,174,87,87,10.223,10.464,2,5
48,7,-1,90,45,45,4.573,4.366,7,8
48,8,-1,134,67,67,7.889,7.688,4,6
48,9,1,127,64,63,7.26,7.386,6,4
48,10,0,50,25,25,2.805,2.726,8,8
48,11,0,50,25,25,2.582,2.384,8,8
48,12,-1,80,40,40,4.65,4.999,5,8
48,13,1,59,30,29,3.245,3.078,8,7
48,14,1,55,28,27,3.224,3.168,8,7
48,15,1,59,30,29,2.969,2.867,8,7
48,16,-1,121,61,60,7.048,6.648,3,5
48,17,-1,86,43,43,4.963,5.26,4,7
48,18,-1,156,78,78,8.601,8.418,4,7
48,19,1,165,83,82,10.149,9.535,6,3
48,20,-1,92,46,46,5.564,5.074,7,8
49,1,0,50,25,25,2.469,2.461,8,8
49,2,1,219,110,109,12.045,12.432,3,2
49,3,-1,96,48,48,5.413,5.425,6,7
49,4,0,50,25,25,2.486,2.457,8,8
49,5,1,155,78,77,8.5,8.539,7,0
49,6,1,113,57,56,6.572,6.038,8,5
49,7,1,197,99,98,11.246,10.989,3,1
49,8,1,155,78,77,8.321,8.373,4,3
49,9,-1,212,106,106,11.735,11.884,2,3
49,10,1,122,61,61,6.624,6.61,6,4
49,11,0,190,95,95,10.347,10.064,3,3
49,12,0,50,25,25,3.198,3.462,8,8
49,13,-1,188,94,94,9.74,10.328,1,6
49,14,0,226,113,113,12.363,12.128,2,2
49,15,0,50,25,25,2.364,2.596,8,8
49,16,0,50,25,25,3.233,3.08,8,8
49,17,1,247,124,123,13.737,13.313,2,0
49,18,1,99,50,49,5.084,5.254,8,6
49,19,0,50,25,25,2.825,2.83,8,8
49,20,1,318,159,159,17.194,16.687,3,2
